111111111111111
100101C1000C111
10001C0P1100111
10001C10E000111
111111111111111
