1111111111
1100001111
10P000C001
1000000E11
1111111111